29 20
63 63 63 63 16 16 16 16 16 16 16 16 16 16 16 16 16 16 16 16 16 16 16 16 16 13 63 63 63
63 9 0 0 16 16 16 16 14 14 14 14 14 14 14 14 14 14 14 14 14 16 16 16 16 0 0 9 63
63 0 0 0 13 16 16 14 14 2 2 2 2 2 2 2 2 2 2 2 14 14 16 16 0 0 0 0 63
63 0 10 0 0 16 16 14 14 2 2 2 2 2 2 2 2 2 2 2 14 14 16 16 0 0 10 0 63
63 63 63 63 63 16 16 14 14 2 2 2 2 2 2 2 2 2 2 2 14 14 16 16 63 0 63 0 63
63 9 0 0 0 16 16 14 14 2 2 2 2 2 2 2 2 2 2 2 14 14 16 16 0 0 0 9 63
63 0 0 0 0 70 71 14 14 2 2 2 2 2 2 2 2 2 2 2 14 14 70 71 0 0 0 0 63
63 0 10 0 68 74 74 73 14 2 2 2 2 2 2 2 2 2 2 2 14 72 74 74 69 0 10 0 63
63 0 0 68 74 74 74 74 73 2 2 2 2 2 2 2 2 2 2 2 72 74 74 74 74 69 0 0 63
63 9 0 0 16 16 16 16 14 14 14 14 14 2 2 2 14 14 14 14 14 16 16 16 16 13 0 9 63
63 0 0 0 16 16 16 16 16 16 16 16 16 67 67 67 16 16 16 16 16 16 16 16 16 0 0 0 63
13 0 10 0 16 16 16 16 16 16 16 16 16 67 67 67 16 16 16 16 16 16 16 16 16 0 10 0 63
63 0 0 0 16 16 16 16 16 16 16 16 16 67 2 67 16 16 16 16 16 16 16 16 16 0 0 0 63
63 9 0 0 16 16 16 16 16 16 16 16 16 2 2 2 16 16 16 16 16 16 16 16 16 0 0 9 63
63 0 0 0 16 16 16 16 16 16 16 16 16 2 2 2 16 16 16 16 16 16 16 16 16 0 0 0 63
63 0 10 0 16 16 16 16 16 16 16 16 16 2 2 2 16 16 16 16 16 16 16 16 16 0 10 0 63
63 0 0 0 16 16 16 16 9 10 9 10 9 0 0 0 9 10 9 10 9 16 16 16 16 0 0 0 63
63 9 0 0 0 0 0 13 0 0 0 0 0 0 62 0 0 0 0 0 0 0 0 0 0 0 0 9 63
63 0 0 0 0 0 0 0 0 0 0 0 0 0 75 0 0 0 0 0 0 0 0 0 0 0 0 0 63
63 63 63 63 63 63 63 63 63 63 63 63 63 63 63 63 63 63 63 63 63 63 63 63 63 63 63 63 63