50 40
7 2 2 2 2 2 2 2 2 2 2 2 2 2 2 2 2 2 2 2 2 2 2 2 2 2 2 2 2 2 2 2 2 2 2 2 2 2 2 2 2 2 2 2 2 2 2 2 2 6
3 0 0 0 0 0 0 0 0 0 0 0 0 0 0 0 0 0 0 0 0 0 0 0 0 0 0 0 0 0 0 0 0 0 0 0 16 20 17 0 0 0 0 0 0 0 0 0 0 4
3 0 10 0 0 16 20 17 0 0 0 0 0 0 0 0 0 0 0 0 0 0 0 0 0 0 0 0 0 0 0 0 0 0 0 0 14 18 15 0 0 0 0 0 0 0 0 22 0 4
3 0 11 0 0 14 18 15 0 0 0 0 0 0 0 0 0 0 0 0 0 0 0 0 0 0 0 0 0 0 0 0 0 0 0 0 0 12 0 0 0 0 0 0 0 0 0 23 0 4
3 0 0 0 0 0 12 0 0 0 0 0 0 0 0 0 19 0 0 0 0 0 0 0 0 0 0 0 0 19 0 0 0 0 0 0 0 0 0 0 0 0 0 0 0 19 0 0 0 4
3 0 0 0 0 0 0 0 0 0 0 0 0 0 0 14 18 15 0 0 0 0 0 0 0 0 0 0 14 21 15 0 0 0 0 0 0 0 0 0 0 0 0 0 14 21 15 0 0 4
3 0 0 0 0 0 0 0 0 0 0 0 0 0 0 0 12 0 0 0 16 20 17 0 0 0 0 0 14 18 15 0 0 0 0 0 0 0 0 0 0 0 0 0 14 21 15 0 0 4
3 0 0 0 0 19 0 0 0 0 0 0 0 19 0 0 0 0 0 0 14 18 15 0 0 0 0 0 0 12 0 0 0 0 0 0 0 0 0 0 0 0 0 0 14 18 15 0 0 4
3 0 0 0 14 21 15 0 0 0 0 0 14 21 15 0 0 0 0 0 0 12 0 0 0 0 0 0 0 0 0 0 0 0 0 0 0 0 0 0 16 20 17 0 0 12 0 0 0 4
3 0 0 0 16 21 17 0 0 0 0 0 14 18 15 0 0 0 0 0 0 0 0 0 0 0 0 0 0 0 0 0 0 0 0 0 0 0 0 0 14 18 15 0 0 0 0 0 0 4
3 0 0 0 14 18 15 0 0 0 0 0 0 13 0 0 0 0 0 0 0 0 0 0 0 0 0 0 0 0 16 20 17 0 0 0 0 0 0 0 0 13 0 0 0 0 0 0 0 4
3 0 0 0 0 12 0 0 0 0 0 0 0 12 0 0 0 0 0 0 0 0 0 0 0 0 0 0 0 0 14 18 15 0 0 0 0 0 0 0 0 12 0 0 0 0 0 0 0 4
3 0 0 0 0 0 0 0 0 0 0 0 0 0 0 0 0 0 0 0 0 0 0 0 0 0 0 0 0 0 0 12 0 0 0 0 0 0 0 0 0 0 0 0 0 0 0 0 0 4
3 0 0 0 16 20 17 0 0 0 0 0 0 0 0 0 0 0 0 0 0 0 0 0 19 0 0 0 0 0 0 0 0 0 0 0 0 0 0 0 0 0 0 0 0 0 0 0 0 4
3 0 0 0 14 21 15 0 0 0 0 0 0 0 0 0 0 0 0 0 0 0 0 14 21 15 0 0 0 0 0 0 0 0 0 0 0 0 0 0 0 0 0 0 0 0 0 0 0 4
3 0 0 0 14 18 15 0 0 0 0 0 0 0 0 0 0 0 0 0 0 0 0 16 21 17 0 0 0 0 0 0 0 0 0 19 0 0 0 0 0 0 0 0 0 0 0 0 0 4
3 0 0 0 0 13 0 0 0 0 0 0 0 0 0 0 0 0 0 0 0 0 0 14 18 15 0 0 0 0 0 0 0 0 14 21 15 0 0 0 0 0 0 16 20 17 0 0 0 4
3 0 0 0 0 12 0 0 0 0 0 0 0 0 16 20 17 0 0 0 0 0 0 0 12 0 0 0 0 0 0 0 0 0 14 18 15 0 0 0 0 0 0 14 18 15 0 0 0 4
3 0 0 0 0 0 0 0 0 0 0 0 0 0 14 18 15 0 0 0 0 0 0 0 0 0 0 0 0 0 0 0 0 0 0 12 0 0 0 0 0 0 0 0 12 0 0 0 0 4
3 0 0 0 0 0 0 0 0 0 0 0 0 0 0 12 0 0 0 0 0 0 0 0 0 0 0 0 0 0 0 0 0 0 0 0 0 0 0 0 0 0 0 0 0 0 0 0 0 4
3 0 0 0 0 0 0 0 0 0 0 0 0 0 0 0 0 0 0 0 0 0 0 0 0 0 0 0 0 0 0 0 0 0 0 0 0 0 0 0 0 0 0 0 0 0 0 0 0 4
3 0 0 0 0 0 0 0 0 0 0 0 0 0 0 0 0 0 0 0 0 0 0 19 0 0 0 0 0 0 0 0 0 0 0 0 0 0 0 0 16 20 17 0 0 0 0 0 0 4
3 0 0 0 0 0 0 16 20 17 0 0 0 0 0 0 16 20 17 0 0 0 14 18 15 0 0 0 0 16 20 17 0 0 0 0 0 0 0 0 14 18 15 0 0 0 0 0 0 4
3 0 0 0 0 0 0 14 18 15 0 0 0 0 0 0 14 21 15 0 0 0 0 13 0 0 0 0 0 14 18 15 0 0 0 0 0 0 0 0 0 12 0 0 0 0 0 0 0 4
3 0 0 0 0 0 0 0 12 0 0 0 0 0 0 0 14 18 15 0 0 0 0 12 0 0 0 0 0 0 12 0 0 0 0 0 0 0 0 0 0 0 0 0 0 0 0 0 0 4
3 0 0 0 0 0 19 0 0 0 0 0 0 0 0 0 0 12 0 0 0 0 0 0 0 0 0 0 0 0 0 0 0 0 0 0 0 0 0 0 0 0 0 0 0 0 0 0 0 4
3 0 0 0 0 14 21 15 0 0 0 0 0 0 0 0 0 0 0 0 0 0 0 16 20 17 0 0 0 0 0 0 0 0 16 20 17 0 0 0 0 0 0 0 0 0 0 0 0 4
3 0 0 0 0 14 21 15 0 0 0 0 0 19 0 0 0 0 0 0 0 0 0 14 21 15 0 0 0 0 0 0 0 0 14 18 15 0 0 0 0 16 20 17 0 0 0 0 0 4
3 0 0 0 0 14 18 15 0 0 0 0 14 21 15 0 0 0 0 0 0 0 0 14 18 15 0 0 0 0 0 0 0 0 0 13 0 0 0 0 0 14 21 15 0 0 0 0 0 4
3 0 0 0 0 0 12 0 0 0 0 0 16 21 17 0 0 0 16 20 17 0 0 0 12 0 0 0 0 0 0 0 0 0 0 12 0 0 0 0 0 14 18 15 0 0 0 0 0 4
3 0 0 0 0 0 0 0 0 0 0 0 14 18 15 0 0 0 14 18 15 0 0 0 0 0 0 0 0 0 0 0 0 0 0 0 0 0 0 0 0 0 12 0 0 0 0 0 0 4
3 0 0 0 0 0 0 0 0 0 0 0 0 12 0 0 0 0 0 13 0 0 0 0 0 0 0 0 0 0 16 20 17 0 0 0 0 0 0 0 0 0 0 0 0 0 0 0 0 4
3 0 0 0 0 0 0 0 0 0 0 0 0 0 0 0 0 0 0 12 0 0 0 0 0 0 0 0 0 0 14 21 15 0 0 0 0 0 0 0 0 0 0 0 0 0 0 0 0 4
3 0 0 0 0 0 0 19 0 0 0 0 0 0 0 0 0 0 0 0 0 0 0 0 0 0 0 0 0 0 16 21 17 0 0 0 0 0 0 0 0 0 0 16 20 17 0 0 0 4
3 0 0 0 0 0 14 18 15 0 0 0 0 0 0 0 0 0 0 16 20 17 0 0 0 0 0 0 0 0 14 18 15 0 0 0 0 0 0 0 0 0 0 14 18 15 0 0 0 4
3 0 0 0 0 0 0 12 0 0 0 0 0 0 0 0 0 0 0 14 21 15 0 0 0 0 0 0 0 0 0 12 0 0 0 0 0 0 0 0 0 0 0 0 12 0 0 0 0 4
3 0 0 0 0 0 0 0 0 0 0 0 0 0 0 0 0 0 0 14 18 15 0 0 0 0 0 0 0 0 0 0 0 0 0 0 0 0 0 0 0 0 0 0 0 0 0 0 0 4
3 0 0 0 0 0 0 0 0 0 0 0 0 0 0 0 0 0 0 0 12 0 0 0 0 0 0 0 0 0 0 0 0 0 0 0 0 0 0 0 0 0 0 0 0 0 0 0 0 4
3 0 0 0 0 0 0 0 0 0 0 0 0 0 0 0 0 0 0 0 0 0 0 0 0 0 0 0 0 0 0 0 0 0 0 0 0 0 0 0 0 0 0 0 0 0 0 0 0 4
8 1 1 1 1 1 1 1 1 1 1 1 1 1 1 1 1 1 1 1 1 1 1 1 1 1 1 1 1 1 1 1 1 1 1 1 1 1 1 1 1 1 1 1 1 1 1 1 1 5