30 20
9 4 4 4 4 4 4 4 4 4 4 4 4 4 4 4 4 4 4 4 4 4 4 4 4 4 4 4 4 8
7 0 0 0 0 0 0 0 0 0 0 0 0 0 0 0 0 0 0 0 0 0 0 0 0 0 0 0 0 6
7 0 12 0 0 0 0 0 0 0 0 0 0 0 0 0 0 0 0 0 0 0 0 0 0 0 0 0 0 6
7 0 13 0 0 0 0 0 0 0 0 0 0 0 0 0 0 0 3 0 0 0 0 0 0 0 0 0 0 6
7 0 0 0 0 0 0 0 0 0 0 0 0 0 0 0 0 0 0 0 0 0 0 0 0 0 0 0 0 6
7 0 0 0 0 0 0 0 0 0 0 0 0 0 0 0 0 0 0 0 0 0 0 0 0 0 0 0 0 6
7 0 0 0 0 0 3 0 0 0 0 16 5 5 5 5 17 0 0 0 0 0 0 0 0 0 0 0 0 6
7 0 0 0 0 0 0 0 0 0 16 10 1 1 1 1 11 17 0 0 0 0 0 0 0 0 0 0 0 6
7 0 0 0 0 0 0 0 0 0 6 1 1 1 1 1 1 7 0 0 0 0 0 0 0 0 0 0 0 6
7 0 0 0 0 0 0 0 0 0 6 1 1 1 1 1 1 7 0 0 0 31 30 32 0 0 0 0 0 6
7 0 0 0 0 0 0 0 0 0 6 1 1 1 1 1 1 7 0 0 31 24 30 25 32 0 0 0 0 6
7 0 0 0 0 0 0 0 0 0 14 8 33 1 1 1 9 15 0 0 24 27 29 28 25 0 0 0 0 6
7 0 0 0 0 0 0 0 0 0 0 14 4 4 4 4 15 0 0 0 27 22 26 23 28 0 0 0 0 6
7 0 0 0 0 0 0 0 0 0 0 0 0 0 0 0 0 0 0 0 22 26 26 26 23 0 0 0 0 6
7 0 0 0 0 0 0 0 0 0 0 0 0 0 0 0 0 0 0 0 18 20 26 20 19 0 0 0 0 6
7 0 0 0 3 0 0 0 0 0 0 0 0 0 0 0 0 0 0 0 18 26 26 26 19 0 0 0 0 6
7 0 0 0 0 0 0 0 0 0 0 0 0 0 0 0 0 0 0 0 18 26 21 26 19 0 0 0 0 6
7 0 0 0 0 0 0 0 0 0 0 0 0 0 0 3 0 0 0 0 0 0 0 0 0 0 0 0 0 6
7 0 0 0 0 0 0 0 0 0 0 0 0 0 0 0 0 0 0 0 0 0 0 0 0 0 0 0 0 6
11 5 5 5 5 5 5 5 5 5 5 5 5 5 5 5 5 5 5 5 5 5 5 5 5 5 5 5 5 10