35 32
27 27 27 27 27 27 27 27 27 27 27 27 27 27 27 27 27 27 27 27 27 27 27 27 27 27 27 27 27 27 27 27 27 27 27
27 0 0 0 0 0 0 0 0 0 0 0 0 0 0 0 0 0 0 0 0 0 0 0 0 0 0 0 0 0 0 0 0 0 27
27 0 0 0 0 0 0 28 0 0 0 0 0 0 0 0 0 0 0 0 0 0 0 0 0 0 10 0 0 28 0 0 0 0 27
27 0 0 18 17 17 17 17 17 19 0 0 0 0 0 0 0 0 0 0 0 0 0 0 0 18 17 17 17 17 17 19 0 0 27
27 0 0 16 16 16 16 16 16 16 0 0 0 0 0 0 0 9 0 0 0 0 0 0 0 16 16 16 16 16 16 16 0 0 27
27 0 0 16 20 16 16 16 20 16 0 0 0 0 0 0 0 0 0 0 0 0 0 0 0 16 20 16 16 16 20 16 0 0 27
27 0 4 66 66 66 22 66 66 66 4 0 0 0 0 0 0 0 0 0 0 0 0 0 4 66 66 66 22 66 66 66 4 0 27
27 0 4 4 4 4 4 4 4 4 4 0 0 0 0 0 0 0 0 0 0 0 0 0 4 4 4 4 4 4 4 4 4 0 27
27 0 4 4 4 4 4 4 4 4 4 0 10 0 0 0 0 0 0 0 0 0 0 0 4 4 4 4 4 4 4 4 4 0 27
27 0 0 0 0 0 0 0 0 0 0 0 0 0 0 0 0 0 0 0 0 0 0 0 0 0 0 0 0 0 0 0 0 0 27
27 0 0 0 9 0 0 0 0 0 0 0 0 0 0 0 0 0 28 0 0 0 0 0 0 0 0 0 9 0 0 0 0 0 27
27 0 0 0 0 0 0 0 0 0 0 0 0 0 18 17 17 17 17 17 19 0 0 0 0 0 0 0 0 0 0 0 0 0 27
27 0 0 0 0 0 0 0 0 0 0 0 0 18 17 17 17 17 17 17 17 19 0 0 0 0 0 0 0 0 0 0 0 0 27
27 0 0 44 51 51 51 51 45 0 0 0 0 16 16 16 16 16 16 16 16 16 0 0 44 51 51 51 51 51 51 45 0 0 27
27 0 0 49 48 48 48 48 50 0 0 0 0 16 16 20 16 16 16 20 16 16 0 0 49 48 52 52 52 52 48 50 0 10 27
27 0 0 49 48 48 48 48 50 0 0 0 0 16 16 16 16 16 16 16 16 16 0 0 47 46 0 55 56 0 49 50 0 0 27
27 0 0 49 48 48 48 48 50 0 0 0 0 16 16 20 16 16 16 20 16 16 0 0 0 0 0 53 54 0 49 50 0 0 27
27 0 0 49 48 48 48 48 50 0 0 0 4 66 66 66 66 22 66 66 66 66 4 0 44 45 0 0 0 0 49 50 0 0 27
27 0 0 47 52 52 52 52 46 0 0 0 4 4 4 4 4 4 4 4 4 4 4 0 49 48 51 51 51 51 48 50 0 0 27
27 0 0 0 0 0 0 0 0 0 0 0 4 4 4 4 4 4 4 4 4 4 4 0 47 52 52 52 52 52 52 46 0 0 27
27 0 0 0 0 0 0 0 0 0 0 0 0 0 0 0 0 0 0 0 0 0 0 0 0 0 0 0 0 0 0 0 0 0 27
27 0 0 0 9 0 0 0 0 0 10 0 0 0 0 0 0 0 0 0 0 0 0 0 0 0 0 0 0 0 0 0 58 0 27
27 0 0 0 0 0 0 0 0 0 0 0 0 0 0 0 0 0 0 0 10 0 0 0 0 0 0 0 0 0 0 0 59 0 27
27 0 0 0 0 0 0 28 0 0 0 0 0 0 0 0 0 0 0 0 0 0 0 0 0 0 0 0 0 28 0 0 0 0 27
27 0 0 18 17 17 17 17 17 19 0 0 0 0 0 0 0 0 0 0 0 0 0 0 0 18 17 17 17 17 17 19 0 0 27
27 0 0 16 16 16 16 16 16 16 0 0 0 9 0 0 0 0 0 0 0 0 0 0 0 16 16 16 16 16 16 16 0 0 27
27 0 0 16 20 16 16 16 20 16 0 0 0 0 0 0 0 0 0 0 0 0 0 0 0 16 20 16 16 16 20 16 0 0 27
27 0 4 66 66 66 22 66 66 66 4 0 0 0 0 0 0 0 0 0 0 0 0 0 4 66 66 66 22 66 66 66 4 0 27
27 0 4 4 4 4 4 4 4 4 4 0 0 0 0 0 0 0 0 0 0 9 0 0 4 4 4 4 4 4 4 4 4 0 27
27 0 4 4 4 4 4 4 4 4 4 0 0 0 0 0 0 0 0 0 0 0 0 0 4 4 4 4 4 4 4 4 4 0 27
27 0 0 0 0 0 0 0 0 0 0 0 0 0 0 0 0 0 0 0 0 0 0 0 0 0 0 0 0 0 0 0 0 0 27
27 27 27 27 27 27 27 27 27 27 27 27 27 27 27 27 27 27 27 27 27 27 27 27 27 27 27 27 27 27 27 27 27 27 27