35 32
27 27 27 27 27 27 27 27 27 27 27 27 27 27 27 27 27 27 27 27 27 27 27 27 27 27 27 27 27 27 27 27 27 27 27
27 0 0 0 0 0 0 0 0 0 0 0 0 0 0 0 0 0 0 28 0 0 0 0 0 0 0 0 0 0 0 0 0 0 27
27 0 0 0 0 0 9 0 0 0 0 0 0 10 0 18 17 17 17 17 19 0 0 0 0 13 0 0 0 0 0 10 0 0 27
27 0 0 0 0 0 0 0 0 0 0 0 0 0 0 20 16 16 16 20 16 0 0 0 0 0 0 0 0 0 0 0 0 0 27
27 0 13 0 0 0 0 0 0 13 0 0 0 0 4 16 16 22 16 16 16 4 0 0 0 0 0 0 0 0 0 0 0 0 27
27 0 0 0 0 0 0 0 0 0 0 0 0 0 4 4 4 4 4 4 4 4 0 0 0 0 0 0 0 0 0 0 0 0 27
27 0 0 0 0 10 0 0 0 0 26 24 24 24 4 4 4 4 4 4 4 4 0 0 0 0 0 9 0 0 0 0 13 0 27
27 0 0 0 0 0 0 0 0 0 25 0 0 0 0 0 0 0 0 0 0 0 0 0 0 0 0 0 0 0 0 0 0 0 27
27 0 0 0 0 0 0 0 0 0 25 0 0 0 0 0 0 0 0 0 0 0 0 0 0 0 0 0 0 0 0 0 0 0 27
27 0 0 9 0 0 0 0 0 0 25 0 0 0 0 0 0 0 0 9 0 0 0 0 0 0 0 0 0 0 10 0 0 0 27
27 0 0 0 0 0 0 0 0 0 25 0 0 0 0 10 0 0 0 0 0 0 0 0 0 0 0 0 0 0 0 0 0 0 27
27 0 0 0 0 0 0 0 0 0 25 0 0 0 0 0 0 0 0 0 0 0 0 0 0 0 0 0 0 0 0 0 0 0 27
27 0 0 0 0 0 0 0 0 0 25 0 0 0 0 0 0 0 0 0 0 0 0 0 10 0 0 0 0 0 0 0 0 0 27
27 0 0 13 0 0 0 0 0 0 25 0 0 0 0 0 0 0 13 0 28 0 0 0 0 0 0 0 0 0 0 9 0 0 27
27 0 0 0 0 0 0 0 0 0 25 0 0 0 0 18 17 17 17 17 17 17 19 0 0 0 0 0 13 0 0 0 0 0 27
27 0 0 0 0 0 0 0 0 0 25 0 0 0 18 17 17 17 17 17 17 17 17 19 0 0 0 0 0 0 0 0 0 0 27
27 0 0 0 0 0 0 0 0 0 25 0 0 0 16 16 16 16 16 16 16 16 16 16 0 0 0 0 0 0 0 0 0 0 27
27 0 0 0 0 0 0 0 0 0 25 0 0 0 16 16 20 16 16 16 16 20 16 16 0 9 0 0 0 0 0 0 0 0 27
27 0 0 0 0 9 0 0 0 0 25 0 0 0 16 16 16 16 16 16 16 16 16 16 0 0 0 0 0 0 10 0 0 0 27
27 0 0 0 0 0 0 0 0 0 25 0 0 0 16 16 20 16 16 16 16 20 16 16 0 0 0 0 0 0 0 0 0 0 27
27 0 0 0 0 0 0 0 0 0 25 0 0 4 16 16 16 16 22 16 16 16 16 16 4 0 0 0 0 0 0 0 0 0 27
27 0 0 0 0 0 0 0 0 0 26 24 24 4 4 4 4 4 4 4 4 4 4 4 4 0 0 0 0 0 0 0 0 0 27
27 0 10 0 0 0 0 0 13 0 25 0 0 4 4 4 4 4 4 4 4 4 4 4 4 0 0 0 0 0 0 0 0 0 27
27 0 0 0 28 0 0 0 0 0 25 0 0 0 0 0 0 0 0 0 0 0 0 0 0 0 0 0 0 0 0 0 0 0 27
27 0 0 18 17 17 17 19 0 0 25 0 0 0 0 0 0 0 0 0 0 0 0 0 0 10 0 0 0 0 0 9 0 0 27
27 0 0 16 16 16 16 16 0 0 25 0 0 0 0 0 0 0 0 0 9 0 0 0 0 0 0 0 0 0 0 0 0 0 27
27 0 0 16 20 16 20 16 0 0 25 0 0 0 0 0 0 0 0 0 0 0 0 0 0 0 0 0 0 0 0 0 0 0 27
27 0 4 16 16 22 16 16 4 0 25 0 0 0 0 10 0 0 0 0 0 0 0 0 13 0 0 0 0 0 0 0 0 0 27
27 0 4 4 4 4 4 4 4 24 26 0 0 0 0 0 0 0 0 0 0 0 0 0 0 0 0 0 0 0 0 0 0 0 27
27 2 2 2 2 2 2 2 2 2 2 2 2 2 2 2 2 2 2 2 2 2 2 2 2 2 2 2 2 2 2 2 2 2 27
27 23 23 23 23 23 23 23 23 23 23 23 23 23 23 23 23 23 23 23 23 23 23 23 23 23 23 23 23 23 23 23 23 23 27
27 27 27 27 27 27 27 27 27 27 27 27 27 27 27 27 27 27 27 27 27 27 27 27 27 27 27 27 27 27 27 27 27 27 27