35 20
0 0 0 0 0 0 0 0 0 0 0 0 0 0 0 0 0 0 0 13 0 0 0 0 0 0 0 0 0 27 0 0 0 0 0
0 0 9 0 0 0 0 0 0 9 0 0 0 0 29 0 38 39 40 41 42 0 0 10 0 0 0 13 0 27 0 0 0 0 0
0 0 0 0 0 0 0 0 0 0 0 0 0 0 30 31 32 33 32 34 35 36 37 0 0 0 0 0 0 27 0 0 0 0 0
0 0 0 0 13 0 10 0 0 0 0 0 0 0 0 0 0 0 0 0 0 0 0 0 0 9 0 0 0 27 0 0 0 0 0
0 0 0 0 0 0 0 0 0 0 0 0 10 0 0 0 0 0 9 0 0 0 0 0 0 0 0 0 0 27 0 0 0 0 0
0 0 9 0 0 0 0 0 0 0 0 0 0 0 0 0 0 0 0 0 28 0 0 0 0 0 0 0 0 27 0 0 0 0 0
0 0 0 0 0 0 0 0 0 0 0 0 0 18 17 17 17 17 17 17 17 17 17 19 0 0 0 0 0 27 0 0 0 0 0
0 0 0 0 0 0 0 0 0 0 0 0 18 17 17 17 17 17 17 17 17 17 17 17 19 0 0 0 0 27 0 0 0 0 0
0 0 0 0 0 0 0 0 9 0 0 18 17 17 17 17 17 17 17 17 17 17 17 17 17 19 0 10 0 27 0 0 0 0 0
0 0 0 10 0 0 0 0 0 0 0 16 16 16 16 16 16 16 16 16 16 16 16 16 16 16 0 0 0 27 0 0 0 0 0
0 0 0 0 0 0 0 0 0 0 0 16 16 20 16 16 20 16 16 16 20 16 16 16 20 16 0 0 0 27 0 0 0 0 0
0 0 0 0 0 0 13 0 0 0 0 16 16 16 16 16 16 16 16 16 16 16 16 16 16 16 0 0 0 27 0 0 0 0 0
0 0 0 0 0 0 0 0 0 0 0 16 16 16 16 16 16 16 16 16 16 16 16 16 16 16 0 0 0 27 0 0 0 0 0
0 0 0 9 0 0 0 0 0 0 0 16 16 20 16 16 20 16 16 16 20 16 16 16 20 16 0 0 0 27 0 0 0 0 0
0 0 0 0 0 0 0 0 0 4 4 16 16 16 16 16 16 16 22 16 16 16 16 16 16 16 4 4 0 27 0 0 0 0 0
0 13 0 0 0 0 0 0 0 4 4 4 4 4 4 4 4 4 4 4 4 4 4 4 4 4 4 4 0 27 0 0 0 0 0
0 0 0 0 0 0 0 10 0 4 4 4 4 4 4 4 4 4 4 4 4 4 4 4 4 4 4 4 0 27 0 0 0 0 0
27 27 27 27 27 27 27 27 27 27 27 27 27 27 27 27 27 27 27 27 27 27 27 27 27 27 27 27 27 27 0 0 0 0 0
0 0 0 0 0 0 0 0 0 0 0 0 0 0 0 0 0 0 0 0 0 0 0 0 0 0 0 0 0 0 0 0 0 0 0
0 0 0 0 0 0 0 0 0 0 0 0 0 0 0 0 0 0 0 0 0 0 0 0 0 0 0 0 0 0 0 0 0 0 0